#########################
#########################
#########################
#########################
#########################
#############P######CCCCF
####################C####
#######CCCCCCC####CCC####
#######C#####C####C######
#######C#####C####C######
##CCCC#C#####C####C######
##C##C#C#####CCCCCC######
SCC##CCC#################
#########################
#########################
#########################
######################### 