#########################
#########################
#########################
#########################
#########################
###CCCCC############CCCCF
###C###C############C####
###CCCCCCCCCCC####CCC####
#######C#####C####C######
#######C#####C####C######
##CCCC#C#####C####C######
##C##C#C#####CCCCCC######
SCC##CCC#################
#########################
#########################
#########################
######################### 