#########################
#########################
#########################
#########################
#########################
###CCCCC############CCCCC
###C###C############C####
###CCCCCCCCCCC####CCC####
#######C#####C####C######
#######C#####C####C######
##CCCC#C#####C####C######
##C##C#C#####CCCCCC######
CCC##CCC#################
#########################
#########################
#########################
######################### 